NO ./images/1.xpm
SO ./images/2.xpm
WE ./images/5.xpm
EA ./images/6.xpm

F  ./images/4.xpm
C  ./images/4.xpm

111111111111111111111111
100000000000000000000001
100005000000000000000001
100000000000000000000001
100000010001000010100001
100000000000000000000001
100012122110000100000001
100000000000000000000001
100000100010001010100001
100000000000000000000001
100000000000000000000001
100012100005000000000001
100000000000000000000001
100000005000005000000001
100000000000000000000001
100000000005000000000001
100010000010000000000001
100000000000000000000001
100010000000000000000001
100000100E05000000000001
100000000000000000000001
111111110000000000000001
111111111111111111111111

