NO ./path_to_north
SO ./path_to_south
WE ./path_to_west
EA ./path_to_east

F 220,100,0
C 225,30,0

1111111111111111111111111
1000000000000000000000001
1011111111111111111111101
1001000000000000000000101
1001000000000000000000101
1001000000000000000000101
1001000000000000000000101
100100000000N000000000101
1001000000000000000000101
1001000000000000000000101
1001000000000000000000101
1011111111111111111111101
1000000000000000000000001
1111111111111111111111111
